NO ./textures/n.xpm

SO ./textures/s.xpm

WE ./textures/w.xpm

EA ./textures/e.xpm

F 220,100,0

C 225,30,255

1111111
1E00011
1000001
1000001
1111111
